111111111111111111
1C00010010010C1CC1
100001001C01001001
1P00000000000000E1
100000000000000001
100001001001001001
10E001C010C1001001
111111111111111111