11111111111111
1CE000000CP001
11111111111111